111111111111111
100222222222001
102222222222201
122222000222221
122200000002221
120000000000021
120000000000021
122200000002221
122222000222221
122222222222221
102222222222201
100222222222001
111111111111111
end